XXXXXXXXXXXXXXXXXXXXXXXXXXXXXXXXXXXX
X W BBBBBBBBB     X    BBBBBBBBBB  X
XBBBBBBBBBBBBBBBBBBBBBBBBBBBBBBBBBBX
XBBBBBBBBBBBBBBBBBBBBBBBBBBBBBBBBBBX
XBBBBBBBBBBBBBBBBBBBBBBBBBBBBBBBBBBX
XBBBBBBBBBBBBBBBBBBBBBBBBBBBBBBBBBBX
XBBBBBBBBBBBBBBBBBBBBBBBBBBBBBBBBBBX
XBBBBBBBBBBBBBBBBBBBBBBBBBBBBBBBBBBX
XBBBBBBBBBBBBBBBBBBBBBBBBBBBBBBBBBBX
XBBBBBBBBBBBBBBBBBBBBBBBBBBBBBBBBBBX
XBBBBBBBBBBBBBBBBBBBBBBBBBBBBBBBBBBX
XBBBBBBBBBBBBBBBBBBBBBBBBBBBBBBBBBBX
XBBBBBBBBBBBBBBBBBBBBBBBBBBBBBBBBBBX
XBBBBBBBBBBBBBBBBBBBBBBBBBBBBBBBBBBX
XBBBBBBBBBBBBBBBBBBBBBBBBBBBBBBBBBBX
XBBBBBBBBBBBBBBBBBBBBBBBBBBBBBBBBBBX
XBBBBBBBBBBBBBBBBBBBBBBBBBBBBBBBBBBX
XBBBBBBBBBBBBBBBBBBBBBBBBBBBBBBBBBBX
XBBBBBBBBBBBBBBBBBBBBBBBBBBBBBBBBBBX
XBBBBBBBBBBBBBBBBBBBBBBBBBBBBBBBBBBX
XBBBBBBBBBBBBBBBBBBBBBBBBBBBBBBBBBBX
XBBBBBBBBBBBBBBBBBBBBBBBBBBBBBBBBBBX
XBBBBBBBBBBBBBBBBBBBBBBBBBBBBBBBBBBX
XBBBBBBBBBBBBBBBBBBBBBBBBBBBBBBBBBBX
XBBBBBBBBBBBBBBBBBBBBBBBBBBBBBBBBBBX
XBBBBBBBBBBBBBBBBBBBBBBBBBBBBBBBBBBX
XBBBBBBBBBBBBBBBBBBBBBBBBBBBBBBBBBBX
XBBBBBBBBBBBBBBBBBBBBBBBBBBBBBBBBBBX
XBBBBBBBBBBBBBBBBBBBBBBBBBBBBBBBBBBX
XBBBBBBBBBBBBBBBBBBBBBBBBBBBBBBBBBBX
XBBBBBBBBBBBBBBBBBBBBBBBBBBBBBBBBBBX
XBBBBBBBBBBBBBBBBBBBBBBBBBBBBBBEBBBX
XXXXXXXXXXXXXXXXXXXXXXXXXXXXXXXXXXXX