XXXXXXXXXXXXXXXXXXXXXXXXXXXXXXXXXXXX
X W BBBBBBBBB     X    BBBBBBBBBB  X
X B           BBB X  B         B B X
X B BBXBBXB BXBBB    B XXXXXX  B B X
X B         BBBBBB B B      X BB   X
X B BBXBXBBXBBBB   BBB  B X X  B B X
X X X X     B    XX   BBB X X BB B X
X X X X     B B   BBBB    X   BBBBXX
X X   B B B    BBXXXXXXXX X B BB  XX
X XB  X     X  B X        X B     XX
X X   X    XXX BBX     G  B B BBB XX
XBBBBBBBBBBBBBBBBBBBBBBBBBBBBBBBBBBX
XBBBBBBBBBBBBBBBBBBBBBBBBBBBBBBBBBBX
XBBBBBBBBBBBBBBBBBBBBBBBBBBBBBBBBBBX
XBBBBBBBBBBBBBBBBBBBBBBBBBBBBBBBBBBX
XBBBBBBBBBBBBBBBBBBBBBBBBBBBBBBBBBBX
XBBBBBBBBBBBBBBBBBBBBBBBBBBBBBBBBBBX
XBBBBBBBBBBBBBBBBBBBBBBBBBBBBBBBBBBX
XBBBBBBBBBBBBBBBBBBBBBBBBBBBBBBBBBBX
XBBBBBBBBBBBBBBBBBBBBBBBBBBBBBBBBBBX
XBBBBBBBBBBBBBBBBBBBBBBBBBBBBBBBBBBX
XBBBBBBBBBBBBBBBBBBBBBBBBBBBBBBBBBBX
XBBBBBBBBBBBBBBBBBBBBBBBBBBBBBBBBBBX
XBBBBBBBBBBBBBBBBBBBBBBBBBBBBBBBBBBX
XBBBBBBBBBBBBBBBBBBBBBBBBBBBBBBBBBBX
XBBBBBBBBBBBBBBBBBBBBBBBBBBBBBBBBBBX
XBBBBBBBBBBBBBBBBBBBBBBBBBBBBBBBBBBX
XBBBBBBBBBBBBBBBBBBBBBBBBBBBBBBBBBBX
XBBBBBBBBBBBBBBBBBBBBBBBBBBBBBBBBBBX
XBBBBBBBBBBBBBBBBBBBBBBBBBBBBBBBBBBX
XBBBBBBBBBBBBBBBBBBBBBBBBBBBBBBBBBBX
XBBBBBBBBBBBBBBBBBBBBBBBBBBBBBBEBBBX
XXXXXXXXXXXXXXXXXXXXXXXXXXXXXXXXXXXX