XXXXXXXXXXXXXXXXXXXXXXXXXXXXXXXXXXXX
X WBBBBBBBBBBBBBBBBBBBBBBBBBBBBBBBX
XBBBBBBBBBBBBBBBBBBBBBBBBBBBBBBBBBBX
XBBBBBBBBBBBBBBBBBBBBBBBBBBBBBBBBBBX
XBBBBBBBBBBBBBBBBBBBBBBBBBBBBBBBBBBX
XBBBBBBBBBBBBBBBBBBBBBBBBBBBBBBBBBBX
XBBBBBBBBBBBBBBBBBBBBBBBBBBBBBBBBBBX
XBBBBBBBBBBBBBBBBBBBBBBBBBBBBBBBBBBX
XBBBBBBBBBBBBBBBBBBBBBBBBBBBBBBBBBBX
XBBBBBBBBBBBBBBBBBBBBBBBBBBBBBBBBBBX
XBBBBBBBBBBBBBBBBBBBBBBBBBBBBBBBBBBX
XBBBBBBBBBBBBBBBBBBBBBBBBBBBBBBBBBBX
XBBBBBBBBBBBBBBBBBBBBBBBBBBBBBBBBBBX
XBBBBBBBBBBBBBBBBBBBBBBBBBBBBBBBBBBX
XBBBBBBBBBBBBBBBBBBBBBBBBBBBBBBBBBBX
XBBBBBBBBBBBBBBBBBBBBBBBBBBBBBBBBBBX
XBBBBBBBBBBBBBBBBBBBBBBBBBBBBBBBBBBX
XBBBBBBBBBBBBBBBBBBBBBBBBBBBBBBBBBBX
XBBBBBBBBBBBBBBBBBBBBBBBBBBBBBBBBBBX
XBBBBBBBBBBBBBBBBBBBBBBBBBBBBBBBBBBX
XBBBBBBBBBBBBBBBBBBBBBBBBBBBBBBBBBBX
XBBBBBBBBBBBBBBBBBBBBBBBBBBBBBBBBBBX
XBBBBBBBBBBBBBBBBBBBBBBBBBBBBBBBBBBX
XBBBBBBBBBBBBBBBBBBBBBBBBBBBBBBBBBBX
XBBBBBBBBBBBBBBBBBBBBBBBBBBBBBBBBBBX
XBBBBBBBBBBBBBBBBBBBBBBBBBBBBBBBBBBX
XBBBBBBBBBBBBBBBBBBBBBBBBBBBBBBBBBBX
XBBBBBBBBBBBBBBBBBBBBBBBBBBBBBBBBBBX
XBBBBBBBBBBBBBBBBBBBBBBBBBBBBBBBBBBX
XBBBBBBBBBBBBBBBBBBBBBBBBBBBBBBBBBBX
XBBBBBBBBBBBBBBBBBBBBBBBBBBBBBBBBBBX
XBBBBBBBBBBBBBBBBBBBBBBBBBBBBBBEBBBX
XXXXXXXXXXXXXXXXXXXXXXXXXXXXXXXXXXXX