XXXXXXXXXXXXXXXXXXXXXXXXXXXXXXXXXXXX
X W         GBBBBBBBBBBBBBBBBBBBBBBX
XBBBBBBBBBBBBBBBBBBBBBBBBBBBBBBBBBBX
XBBBBBBBBBBBBBBBBBBBBBBBBBBBBBBBBBBX
XBBBBBBBBBBBBBBBBBBBBBBBBBBBBBBBBBBX
XBBBBBBBBBBBBBBBBBBBBBBBBBBBBBBBBBBX
XBBBBBBBBBBBBBBBBBBBBBBBBBBBBBBBBBBX
XBBBBBBBBBBBBBBBBBBBBBBBBBBBBBBBBBBX
XBBBBBBBBBBBBBBBBBBBBBBBBBBBBBBBBBBX
XBBBBBBBBBBBBBBBBBBBBBBBBBBBBBBBBBBX
XBBBBBBBBBBBBBBBBBBBBBBBBBBBBBBBBBBX
XBBBBBBBBBBBBBBBBBBBBBBBBBBBBBBBBBBX
XBBBBBBBBBBBBBBBBBBBBBBBBBBBBBBBBBBX
XBBBBBBBBBBBBBBB   BBBBBBBBBBBBBBBBX
XBBBBBBBBBBBBBBB   BBBBBBBBBBBBBBBBX
XBBBBBBBBBBBBBBBBBBBBBBBBBBBBBBBBBBX
XBBBBBBBBBBBBBBBBBBBBBBBBBBBBBBBBBBX
XBBBBBBBBBBBBBBBBBBBBBBBBBBBBBBBBBBX
XBBBBBBBBBBBBBBBBBBBBBBBBBBBBBBBBBBX
XBBBBBBBBBBBBBBBBBBBBBBBBBBBBBBBBBBX
XBBBBBBBBBBBBBBBBBBBBBBBBBBBBBBBBBBX
XBBBBBBBBBBBBBBBBBBBBBBBBBBBBBBBBBBX
XBBBBBBBBBBBBBBBBBBBBBBBBBBBBBBBBBBX
XBBBBBBBBBBBBBBBBBBBBBBBBBBBBBBBBBBX
XBBBBBBBBBBBBBBBBBBBBBBBBBBBBBBBBBBX
XBBBBBBBBBBBBBBBBBBBBBBBBBBBBBBBBBBX
XBBBBBBBBBBBBBBBBBBBBBBBBBBBBBBBBBBX
XBBBBBBBBBBBBBBBBBBBBBBBBBBBBBBBBBBX
XBBBBBBBBBBBBBBBBBBBBBBBBBBBBBBBBBBX
XBBBBBBBBBBBBBBBBBBBBBBBBBBBBBBBBBBX
XBBBBBBBBBBBBBBBBBBBBBBBBBBBBBBBBBBX
XBBBBBBBBBBBBBBBBBBBBBBBBBBBBBBEBBBX
XXXXXXXXXXXXXXXXXXXXXXXXXXXXXXXXXXXX